1,12,2,-1,1,24,24
1,12,2,-1,1,108,108
1,12,2,-1,1,180,180
1,12,2,-1,1,228,228
1,12,2,-1,1,264,264
1,12,2,-1,1,336,336
1,12,2,-1,1,420,420
1,12,2,-1,1,444,444
1,12,2,-1,1,468,468
1,12,2,-1,1,552,552
1,12,2,-1,1,576,576
1,12,2,-1,1,624,624
1,12,2,-1,1,684,684
1,12,2,-1,1,732,732
1,12,2,-1,1,816,816
1,12,2,-1,1,888,888
1,12,2,-1,1,912,912
1,12,2,-1,1,972,972
1,12,2,-1,1,1020,1020
1,12,2,-1,1,1128,1128
1,12,2,-1,1,1152,1152
1,12,2,-1,1,1176,1176
