1,3,2,-1,1,6,6
1,3,2,-1,1,27,27
1,3,2,-1,1,45,45
1,3,2,-1,1,57,57
1,3,2,-1,1,66,66
1,3,2,-1,1,84,84
1,3,2,-1,1,105,105
1,3,2,-1,1,111,111
1,3,2,-1,1,117,117
1,3,2,-1,1,138,138
1,3,2,-1,1,144,144
1,3,2,-1,1,156,156
1,3,2,-1,1,171,171
1,3,2,-1,1,183,183
1,3,2,-1,1,204,204
1,3,2,-1,1,222,222
1,3,2,-1,1,228,228
1,3,2,-1,1,243,243
1,3,2,-1,1,255,255
1,3,2,-1,1,282,282
1,3,2,-1,1,288,288
1,3,2,-1,1,294,294
