1,15,2,-1,1,45,45
1,15,2,-1,1,105,105
1,15,2,-1,1,255,255
1,15,2,-1,1,315,315
1,15,2,-1,1,360,360
1,15,2,-1,1,390,390
1,15,2,-1,1,420,420
1,15,2,-1,1,450,450
1,15,2,-1,1,480,480
1,15,2,-1,1,510,510
1,15,2,-1,1,540,540
1,15,2,-1,1,570,570
1,15,2,-1,1,600,600
1,15,2,-1,1,630,630
1,15,2,-1,1,660,660
1,15,2,-1,1,735,735
1,15,2,-1,1,825,825
1,15,2,-1,1,885,885
1,15,2,-1,1,945,945
1,15,2,-1,1,1140,1140
1,15,2,-1,1,1200,1200
