1,6,2,-1,1,12,12
1,6,2,-1,1,42,42
1,6,2,-1,1,66,66
1,6,2,-1,1,72,72
1,6,2,-1,1,78,78
1,6,2,-1,1,102,102
1,6,2,-1,1,120,120
1,6,2,-1,1,162,162
1,6,2,-1,1,174,174
1,6,2,-1,1,180,180
1,6,2,-1,1,198,198
1,6,2,-1,1,222,222
1,6,2,-1,1,228,228
1,6,2,-1,1,240,240
1,6,2,-1,1,282,282
1,6,2,-1,1,300,300
