1,17,2,-1,1,102,102
1,17,2,-1,1,119,119
1,17,2,-1,1,153,153
1,17,2,-1,1,187,187
1,17,2,-1,1,221,221
1,17,2,-1,1,238,238
1,17,2,-1,1,255,255
1,17,2,-1,1,323,323
1,17,2,-1,1,340,340
1,17,2,-1,1,391,391
1,17,2,-1,1,561,561
1,17,2,-1,1,578,578
1,17,2,-1,1,612,612
1,17,2,-1,1,680,680
1,17,2,-1,1,697,697
1,17,2,-1,1,782,782
1,17,2,-1,1,816,816
1,17,2,-1,1,833,833
1,17,2,-1,1,850,850
1,17,2,-1,1,884,884
1,17,2,-1,1,952,952
1,17,2,-1,1,1071,1071
1,17,2,-1,1,1156,1156
