1,18,2,-1,1,72,72
1,18,2,-1,1,162,162
1,18,2,-1,1,180,180
1,18,2,-1,1,198,198
1,18,2,-1,1,342,342
1,18,2,-1,1,360,360
1,18,2,-1,1,432,432
1,18,2,-1,1,576,576
1,18,2,-1,1,612,612
1,18,2,-1,1,702,702
1,18,2,-1,1,738,738
1,18,2,-1,1,810,810
1,18,2,-1,1,954,954
1,18,2,-1,1,972,972
1,18,2,-1,1,1080,1080
1,18,2,-1,1,1116,1116
1,18,2,-1,1,1152,1152
