1,9,2,-1,1,27,27
1,9,2,-1,1,54,54
1,9,2,-1,1,81,81
1,9,2,-1,1,108,108
1,9,2,-1,1,135,135
1,9,2,-1,1,153,153
1,9,2,-1,1,180,180
1,9,2,-1,1,225,225
1,9,2,-1,1,243,243
1,9,2,-1,1,270,270
1,9,2,-1,1,297,297
